##################################################################################
#     #                       #                                                  # 
#     #                       #                   #                              #
#     #   #################   #   #########   #   #########   ####################
#     #       #   #           #   #           #               #       #          #
#     #####   #   #   #############   #########################   #####   ########
#             #   #               #   #           #       #               #     V#
###############   #############   #   #   #####   #   #   #####   #########   ####
#                 #               #           #       #       #       #       ####
#     #############   #####################################   #########   ########
#                     #                       #                           #      #
#     #################   #   #   #   #####   #   #############   #########   ####
#                         #   #   #   #           #       #       #           # ##
###############   #       #   #   #   #   # # #   #   # # #   #   # # # # #   # ## 
##################################################################################
 